Farmhouse Kings Cross	Sydney	$$
Friggitoria	Sydney	$
The Baxter Inn	Sydney	$$$
Zahli	Sydney	$$
est	Sydney	$$$$
Thai Pothong	Sydney	$$$
Fortune Village Chinese	Sydney	$$
Tetsuya's	Sydney	$$$$
Mamak	Sydney	$
Spice Alley	Sydney	$
Maha	Melbourne	$$$$
Coda	Melbourne	$$$$
Roule Galette	Melbourne	$
Laksa King	Melbourne	$
Scopri	Melbourne	$$
Il Cantuccio	Melbourne	$$$
Eau De Vie	Melbourne	$$
Rice Paper Scissors	Melbourne	$$$
Sezar	Sydney	$$
Rabbath Burleigh	Gold Coast	$$
De Vito Waterfront	Gold Coast	$$$
Iyara thai	Gold Coast	$$
Little Truffle Dining Room	Gold Coast	$$$$
Allure on Currumbin	Gold Coast	$$$$
Shiraz Moderna	Gold Coast	$
Curry Express	Gold Coast	$
