Oh Lala!	Playa del Carmen	$$$$
Cenacolo	Playa del Carmen	$$$$
Kaxapa Factory	Playa del Carmen	$
El Tenedor	Playa del Carmen	$
La Brocherie	Playa del Carmen	$
Falafel Nessya	Playa del Carmen	$
Imprevist	Playa del Carmen	$$
Mar de Olicos	Playa del Carmen	$$$
Club de la Cerveza 	Playa del Carmen	$$
NAU	Playa del Carmen	$$$
La Casona	Cabo San Lucas	$$$$
La Roca	Cabo San Lucas	$$$$
Doggy Style	Cabo San Lucas	$
The Taco Bar	Cabo San Lucas	$
El Peregrino	Cabo San Lucas	$$
La Catrina Restaurant	Cabo San Lucas	$$$
Sunset Point	Cabo San Lucas	$$
Invita Bistro	Cabo San Lucas	$$$
Black Hole	Cancun	$$$$
Las Brasilenas	Cancun	$
Pik Nik	Cancun	$
Restaurante Careyes	Cancun	$$$$
Peter's Restaurant	Cancun	$$
Nomads Cocina & Barra	Cancun	$$$
La Dolce Vita	Cancun	$$
Limoncello	Cancun	$$$
