Xplor Park	Playa del Car	$$$
Xcaret Eco Theme Pakr	Playa del Car	$$$
Rio Secreto	Playa del Car	$$
Cenote Chaak Tun	Playa del Car	$$
Riviera Maya	Playa del Car	Free
Cenote Chikin Ha	Playa del Car	Free
La Playa Xpuha	Playa del Car	Free
Riviera Art Gallery	Playa del Car	$
Playa Aquarium	Playa del Car	$
Chileno Beach	Cabo San Lucas	Free
Bay of Cabo San Lucas	Cabo San Lucas	Free
Santa Maria Beach	Cabo San Lucas	Free
Wild Canyon Adventure	Cabo San Lucas	$$
Arte de Origen	Cabo San Lucas	$
Playa del Amor	Cabo San Lucas	Free
Playa Delfines	Cancun	Free
Avenida Kukulkan	Cancun	Free
Dolphin Discovery	Cancun	$$$
Torre Escenica	Cancun	$
Tulum Avenue	Cancun	Free
Beto Avila Stadium	Cancun	$$
Iglesia de Cristo Rey	Cancun	Free
