Jardin Majorelle	Marrakech	Free
Ben Youssef Madrasa	Marrakech	Free
Photography Museum of Marrakech	Marrakech	$$
Medina of Marrakech	Marrakech	$
Bahia Palace	Marrakech	Free
Marrakech Souk	Marrakech	$
Jemaa el-Fnaa	Marrakech	$
Station Marrakesh	Marrakech	Free
Hassan II Mosque	Casablanca	Free
Quartier Habous	Casablanca	$
The Corniche	Casablanca	Free
Ain Diab	Casablanca	Free
Notre Dame de Lourdes	Casablanca	Free
Musee Abderrahman Slaoui	Casablanca	$$
Medina of Fes	Fes	$
Fes el-Bali	Fes	Free
Jardin Jnan Sbil	Fes	Free
Bab Boujloud	Fes	Free
Nejjarine Museum of Wood Arts and Crafts	Fes	$$
Moulay Abdellah Quarter	Fes	Free
